11111111111111111111111111
10000100100000000000000001
10000E00000000000000000001
100001000C00000000C0000001
10000C0000000000C000000001
10000000000C00000000000001
100000000001000000P0000001
11111111111111111111111111