11111111111111111111111111
1000010000100000E000000001
10000100000000000000000001
100001000C00000000C0000001
10000C0000000000C000000001
10000000000C00000000000001
1000000000000000P000000001
11111111111111111111111111